# English 100k Failures - Tone Markers
# Cause: words ending with s/f/r/x/j trigger tone marks
# Format: WORD \t ACTUAL \t BUFFER
# Total: 1254 (+ 148 both)
#
# WORD: English word typed
# ACTUAL: engine output after space
# BUFFER: Vietnamese transform state before space

of	ò	ò
is	í	í
as	á	á
was	ứa	ứa
this	thí	thí
or	ỏ	ỏ
his	hí	hí
her	hẻ	hẻ
has	há	há
if	ì	ì
its	ít	ít
us	ú	ú
thus	thú	thú
war	ửa	ửa
off	of	of
days	dáy	dáy
terms	tém	tém
major	mảo	mảo
air	ải	ải
basis	bái	bái
nor	nỏ	nỏ
six	sĩ	sĩ
says	sáy	sáy
tax	tã	tã
yes	yé	yé
chief	chiè	chiè
sir	sỉ	sỉ
der	dẻ	dẻ
box	bõ	bõ
car	cả	cả
des	dé	dé
paris	pái	pái
sex	sẽ	sẽ
gas	gá	gá
arms	ám	ám
hair	hải	hải
uses	ues	ues
les	lé	lé
bar	bả	bả
lies	lié	lié
sets	sét	sét
los	ló	ló
pieces	piếc	piếc
chair	chải	chải
sons	són	són
turns	tún	tún
axis	ái	ái
poems	poém	poém
ex	ẽ	ẽ
lips	líp	líp
trans	trán	trán
runs	rún	rún
honor	hổn	hổn
cars	cá	cá
songs	sóng	sóng
bus	bú	bú
virus	víu	víu
loans	loán	loán
wars	ứa	ứa
das	dá	dá
res	ré	ré
max	mã	mã
mix	mĩ	mĩ
tons	tón	tón
dans	dán	dán
guns	gún	gún
maps	máp	máp
pairs	pái	pái
themes	thếm	thếm
es	é	é
bias	bía	bía
marx	mã	mã
ties	tié	tié
norms	nóm	nóm
phys	phý	phý
sur	sủ	sủ
lots	lót	lót
bars	bá	bá
poets	poét	poét
rays	ráy	ráy
las	lá	lá
lens	lén	lén
er	ẻ	ẻ
ix	ĩ	ĩ
bits	bít	bít
rats	rát	rát
moses	moes	moes
boats	boát	boát
thereof	thềo	thềo
buyer	buyẻ	buyẻ
tries	trié	trié
rises	ries	ries
cuts	cút	cút
chiefs	chié	chié
doses	does	does
pays	páy	páy
ussr	usr	usr
guys	guý	guý
posts	pots	pots
sins	sín	sín
dies	dié	dié
trips	tríp	tríp
chaos	cháo	cháo
chairs	chái	chái
burns	bún	bún
tips	típ	típ
hans	hán	hán
hers	hé	hé
vis	ví	ví
rests	rets	rets
lungs	lúng	lúng
cups	cúp	cúp
donor	dổn	dổn
ar	ả	ả
sums	súm	súm
dos	dó	dó
cats	cát	cát
ins	ín	ín
ref	rè	rè
auf	àu	àu
buyers	buyé	buyé
os	ó	ó
dis	dí	dí
photos	phốt	phốt
sits	sít	sít
loses	loes	loes
gaps	gáp	gáp
ir	ỉ	ỉ
mar	mả	mả
ass	as	as
wax	ữa	ữa
nuts	nút	nút
mars	má	má
museums	mueums	mueums
bis	bí	bí
ser	sẻ	sẻ
lets	lét	lét
ups	úp	úp
chips	chíp	chíp
aus	áu	áu
roses	roes	roes
cox	cõ	cõ
nos	nó	nó
refuses	rếu	rếu
cues	cué	cué
aux	ãu	ãu
irs	í	í
toes	toé	toé
var	vả	vả
tops	tóp	tóp
luis	lúi	lúi
hits	hít	hít
tor	tỏ	tỏ
cor	cỏ	cỏ
tis	tí	tí
horns	hón	hón
tens	tén	tén
imf	ìm	ìm
buses	bues	bues
choir	chỏi	chỏi
hips	híp	híp
poses	poes	poes
donors	dốn	dốn
hats	hát	hát
ses	sé	sé
af	à	à
coats	coát	coát
diets	diét	diét
dots	dót	dót
worms	ướm	ướm
traps	tráp	tráp
mais	mái	mái
caps	cáp	cáp
thief	thiè	thiè
xix	xĩ	xĩ
goats	goát	goát
hairs	hái	hái
myers	myé	myé
nets	nét	nét
ngos	ngó	ngó
cans	cán	cán
conf	còn	còn
lays	láy	láy
honors	hốn	hốn
tier	tiẻ	tiẻ
roar	roả	roả
sans	sán	sán
basins	bains	bains
cas	cá	cá
lasts	lats	lats
tar	tả	tả
mis	mí	mí
ox	õ	õ
pier	piẻ	piẻ
buys	buý	buý
cos	có	có
nuns	nún	nún
casts	cats	cats
carr	car	car
nests	nets	nets
dwarf	dừa	dừa
apr	ảp	ảp
basics	baics	baics
cops	cóp	cóp
dams	dám	dám
nur	nủ	nủ
yr	ỷ	ỷ
char	chả	chả
dir	dỉ	dỉ
gangs	gáng	gáng
ax	ã	ã
dues	dué	dué
cores	coé	coé
huts	hút	hút
pores	poé	poé
chores	choé	choé
coasts	coats	coats
pests	pets	pets
rex	rẽ	rẽ
dyes	dyé	dyé
surf	sù	sù
ef	è	è
hangs	háng	háng
bois	bói	bói
ans	án	án
dar	dả	dả
ter	tẻ	tẻ
herr	her	her
mas	má	má
aj	ạ	ạ
turf	tù	tù
mir	mỉ	mỉ
oj	ọ	ọ
charms	chám	chám
boris	bói	bói
laos	láo	láo
raj	rạ	rạ
oats	oát	oát
chef	chè	chè
doris	dói	dói
ther	thẻ	thẻ
ester	ểt	ểt
bats	bát	bát
lor	lỏ	lỏ
lois	lói	lói
sus	sú	sú
gis	gí	gí
cons	cón	cón
ores	oé	oé
piers	pié	pié
majors	máo	máo
loaf	loà	loà
pius	píu	píu
vor	vỏ	vỏ
ras	rá	rá
pesos	péo	péo
ur	ủ	ủ
mats	mát	mát
bays	báy	báy
liar	lỉa	lỉa
cures	cué	cué
boer	boẻ	boẻ
noses	noes	noes
barr	bar	bar
mer	mẻ	mẻ
esters	ết	ết
sachs	sách	sách
ber	bẻ	bẻ
sas	sá	sá
trays	tráy	tráy
mores	moé	moé
mus	mú	mú
bas	bá	bá
guts	gút	gút
gus	gú	gú
inf	ìn	ìn
eros	éo	éo
thorax	thoã	thoã
chaps	cháp	cháp
muir	mủi	mủi
losers	loé	loé
dieser	diể	diể
ver	vẻ	vẻ
ws	ứ	ứ
afar	ẩ	ẩ
mos	mó	mó
raf	rà	rà
oasis	oái	oái
sis	sí	sí
dyer	dyẻ	dyẻ
thorns	thón	thón
yer	yẻ	yẻ
uss	us	us
hens	hén	hén
boxer	boẻ	boẻ
tres	tré	tré
err	er	er
lax	lã	lã
lex	lẽ	lẽ
hays	háy	háy
defends	đến	đến
taps	táp	táp
boar	boả	boả
kits	kít	kít
def	dè	dè
hermes	hếm	hếm
chests	chets	chets
loser	loẻ	loẻ
pies	pié	pié
vers	vé	vé
har	hả	hả
lis	lí	lí
ems	ém	ém
masons	maons	maons
sar	sả	sả
hier	hiẻ	hiẻ
boasts	boats	boats
trois	trói	trói
bur	bủ	bủ
barns	bán	bán
airs	ái	ái
tiers	tié	tié
gums	gúm	gúm
ars	á	á
mes	mé	mé
gays	gáy	gáy
ej	ẹ	ẹ
bets	bét	bét
xerox	xẽo	xẽo
noir	nỏi	nỏi
uns	ún	ún
hues	hué	hué
vas	vá	vá
sores	soé	soé
yrs	ý	ý
oars	oá	oá
sox	sõ	sõ
iff	if	if
tris	trí	trí
harms	hám	hám
ers	é	é
visas	vía	vía
nas	ná	ná
serfs	sé	sé
muses	mues	mues
dix	dĩ	dĩ
refs	ré	ré
bor	bỏ	bỏ
voir	vỏi	vỏi
twas	tứa	tứa
tex	tẽ	tẽ
posits	poits	poits
vos	vó	vó
sens	sén	sén
bins	bín	bín
soar	soả	soả
boers	boé	boé
liens	lién	lién
queues	quếu	quếu
ics	íc	íc
orr	or	or
ij	ị	ị
boas	boá	boá
taxis	tái	tái
mosaics	moaics	moaics
docs	dóc	dóc
kraus	kráu	kráu
hops	hóp	hóp
dips	díp	díp
dwarfs	dứa	dứa
casas	cas	cas
ecr	ẻc	ẻc
masts	mats	mats
mists	mits	mits
uf	ù	ù
eps	ép	ép
tins	tín	tín
oar	oả	oả
ons	ón	ón
acs	ác	ác
emf	èm	èm
rams	rám	rám
sys	sý	sý
wj	ự	ự
denser	dển	dển
ops	óp	óp
truer	truẻ	truẻ
chops	chóp	chóp
suis	súi	súi
soaps	soáp	soáp
longs	lóng	lóng
mens	mén	mén
oas	oá	oá
lars	lá	lá
ams	ám	ám
swans	sưán	sưán
mor	mỏ	mỏ
theseus	thếu	thếu
vans	ván	ván
oss	os	os
mays	máy	máy
thor	thỏ	thỏ
ies	ié	ié
gar	gả	gả
mans	mán	mán
hex	hẽ	hẽ
ess	es	es
suns	sún	sún
trier	triẻ	triẻ
qos	qó	qó
swarms	sưám	sưám
aix	ãi	ãi
hereof	hềo	hềo
dif	dì	dì
lamar	lẩm	lẩm
sacs	sác	sác
purer	puer	puer
ajax	ẫ	ẫ
ips	íp	íp
dieses	dies	dies
esr	ẻ	ẻ
taos	táo	táo
tes	té	té
laps	láp	láp
moser	moẻ	moẻ
reps	rép	rép
mosses	moses	moses
lux	lũ	lũ
vir	vỉ	vỉ
mons	món	món
ias	ía	ía
ros	ró	ró
cur	củ	củ
chiapas	chíâp	chíâp
chefs	ché	ché
bos	bó	bó
sos	só	só
nis	ní	ní
parr	par	par
kris	krí	krí
hoses	hoes	hoes
samaj	sậm	sậm
lans	lán	lán
rus	rú	rú
dens	dén	dén
bir	bỉ	bỉ
bans	bán	bán
swaps	sưáp	sưáp
hoax	hoã	hoã
mins	mín	mín
aps	áp	áp
epr	ẻp	ẻp
nurs	nú	nú
choirs	chói	chói
hangar	hẩng	hẩng
gif	gì	gì
wf	ừ	ừ
hors	hó	hó
nox	nõ	nõ
lys	lý	lý
ifs	í	í
dais	dái	dái
tarsus	táu	táu
tas	tá	tá
sor	sỏ	sỏ
ys	ý	ý
doer	doẻ	doẻ
ims	ím	ím
lair	lải	lải
perseus	pếu	pếu
ets	ét	ét
bums	búm	búm
anwar	ẩn	ẩn
lar	lả	lả
tongs	tóng	tóng
liars	lía	lía
bangs	báng	báng
nieces	niếc	niếc
coax	coã	coã
usaf	ùa	ùa
ens	én	én
tics	tíc	tíc
iss	is	is
moms	móm	móm
lynx	lỹn	lỹn
dias	día	día
eos	éo	éo
busts	buts	buts
lures	lué	lué
dwyer	dưyẻ	dưyẻ
hos	hó	hó
serf	sè	sè
mises	mies	mies
ecj	ẹc	ẹc
vests	vets	vets
ajar	ẩ	ẩ
marr	mar	mar
mies	mié	mié
urns	ún	ún
eff	ef	ef
choses	choes	choes
huns	hún	hún
moans	moán	moán
tamar	tẩm	tẩm
cher	chẻ	chẻ
rojas	roá	roá
congr	cỏng	cỏng
irr	ir	ir
gusts	guts	guts
hamas	hấm	hấm
puranas	puấn	puấn
quits	quít	quít
nots	nót	nót
boxers	boé	boé
maj	mạ	mạ
taj	tạ	tạ
cusps	cups	cups
twos	tướ	tướ
arf	à	à
nes	né	né
nair	nải	nải
dor	dỏ	dỏ
ucs	úc	úc
ker	kẻ	kẻ
mots	mót	mót
bier	biẻ	biẻ
trojans	troán	troán
lias	lía	lía
tur	tủ	tủ
ner	nẻ	nẻ
otros	ốt	ốt
bores	boé	boé
afr	ả	ả
borer	boer	boer
puis	púi	púi
uj	ụ	ụ
gasps	gaps	gaps
haus	háu	háu
chas	chá	chá
lusts	luts	luts
ius	íu	íu
mair	mải	mải
mex	mẽ	mẽ
icj	ịc	ịc
sars	sá	sá
hus	hú	hú
thar	thả	thả
mujer	muẻ	muẻ
terns	tén	tén
nasir	nải	nải
amar	ẩm	ẩm
buns	bún	bún
rungs	rúng	rúng
lif	lì	lì
tues	tué	tué
soes	soé	soé
mesons	meons	meons
roars	roá	roá
roms	róm	róm
bakr	bảk	bảk
tits	tít	tít
nics	níc	níc
sofas	soá	soá
xerxes	xế	xế
maris	mái	mái
mets	mét	mét
dur	dủ	dủ
chir	chỉ	chỉ
vox	võ	võ
lamas	lấm	lấm
musings	muings	muings
usr	ủ	ủ
cots	cót	cót
dons	dón	dón
nar	nả	nả
hajj	haj	haj
toms	tóm	tóm
vaux	vãu	vãu
mayr	mảy	mảy
gans	gán	gán
benes	bến	bến
byers	byé	byé
hams	hám	hám
borax	boã	boã
dusts	duts	duts
thais	thái	thái
vats	vát	vát
ais	ái	ái
chats	chát	chát
bestseller	betseller	betseller
hor	hỏ	hỏ
toasts	toats	toats
ocr	ỏc	ỏc
sams	sám	sám
vax	vã	vã
theor	thẻo	thẻo
aff	af	af
doers	doé	doé
sufis	súi	súi
mois	mói	mói
surer	suer	suer
mems	mém	mém
ris	rí	rí
hoar	hoả	hoả
ves	vé	vé
uar	ủa	ủa
ruts	rút	rút
duns	dún	dún
ors	ó	ó
arr	ar	ar
sips	síp	síp
ler	lẻ	lẻ
hoes	hoé	hoé
monogr	mổng	mổng
topos	tốp	tốp
sirs	sí	sí
tos	tó	tó
ats	át	át
thos	thó	thó
tof	tò	tò
rosas	roas	roas
marais	mấi	mấi
ipr	ỉp	ỉp
sues	sué	sué
wor	ưở	ưở
hir	hỉ	hỉ
tyr	tỷ	tỷ
cams	cám	cám
pasts	pats	pats
mof	mò	mò
amr	ảm	ảm
ries	rié	rié
bij	bị	bị
gur	gủ	gủ
ospf	òp	òp
rer	rẻ	rẻ
mujeres	muế	muế
trams	trám	trám
ocs	óc	óc
varus	váu	váu
neues	nếu	nếu
nir	nỉ	nỉ
hof	hò	hò
dads	đá	đá
manas	mấn	mấn
tors	tó	tó
casings	caings	caings
naps	náp	náp
quests	quets	quets
ipx	ĩp	ĩp
hur	hủ	hủ
hons	hón	hón
voix	või	või
eof	èo	èo
basses	bases	bases
ajr	ả	ả
secs	séc	séc
sais	sái	sái
isps	ips	ips
lors	ló	ló
quasars	quấ	quấ
conor	cổn	cổn
nuer	nuẻ	nuẻ
goers	goé	goé
quis	quí	quí
chins	chín	chín
ochs	óch	óch
pues	pué	pué
phasor	phảo	phảo
wwf	wf	wf
asr	ả	ả
pierces	piếc	piếc
tus	tú	tú
surfers	sué	sué
termes	tếm	tếm
soars	soá	soá
thurs	thú	thú
ques	qué	qué
thiers	thié	thié
nasr	nả	nả
ecs	éc	éc
itr	ỉt	ỉt
atr	ảt	ảt
isr	ỉ	ỉ
ier	iẻ	iẻ
surfer	suẻ	suẻ
gats	gát	gát
rips	ríp	ríp
marys	máy	máy
saps	sáp	sáp
neuer	nểu	nểu
saf	sà	sà
anas	ấn	ấn
macs	mác	mác
mur	mủ	mủ
icr	ỉc	ỉc
baur	bảu	bảu
hes	hé	hé
vier	viẻ	viẻ
echr	ẻch	ẻch
darfur	dảu	dảu
duets	duét	duét
boars	boá	boá
bax	bã	bã
parris	paris	paris
isms	ims	ims
cosas	coas	coas
heures	hếu	hếu
thongs	thóng	thóng
nomos	nốm	nốm
kiefer	kiể	kiể
mayas	mấy	mấy
hofer	hoẻ	hoẻ
purser	puẻ	puẻ
mesures	mếu	mếu
luxor	luỏ	luỏ
myer	myẻ	myẻ
nies	nié	nié
nix	nĩ	nĩ
tapas	tấp	tấp
ux	ũ	ũ
bes	bé	bé
dex	dẽ	dẽ
tures	tué	tué
armas	ấm	ấm
ecf	èc	èc
neusner	nểun	nểun
dorms	dóm	dóm
vex	vẽ	vẽ
tir	tỉ	tỉ
urs	ú	ú
ters	té	té
soir	sỏi	sỏi
lacs	lác	lác
asf	à	à
engrs	éng	éng
lix	lĩ	lĩ
quays	quáy	quáy
kips	kíp	kíp
tener	tển	tển
xor	xỏ	xỏ
duras	dúa	dúa
aos	áo	áo
vets	vét	vét
bef	bè	bè
tamas	tấm	tấm
atf	àt	àt
rif	rì	rì
choix	chõi	chõi
inr	ỉn	ỉn
rots	rót	rót
menger	mểng	mểng
corns	cón	cón
bers	bé	bé
durer	duer	duer
aris	ái	ái
gongs	góng	góng
tans	tán	tán
becher	bểch	bểch
ietf	ièt	ièt
haj	hạ	hạ
mips	míp	míp
gos	gó	gó
manx	mãn	mãn
hurons	huón	huón
berets	bết	bết
yf	ỳ	ỳ
cus	cú	cú
sof	sò	sò
ror	rỏ	rỏ
darauf	dầu	dầu
memes	mếm	mếm
orf	ò	ò
raps	ráp	ráp
naf	nà	nà
saks	sák	sák
borers	boers	boers
corsair	coải	coải
acr	ảc	ảc
vies	vié	vié
ucr	ủc	ủc
trims	trím	trím
parsis	pái	pái
kharif	khài	khài
buf	bù	bù
icf	ìc	ìc
dof	dò	dò
busses	buses	buses
maf	mà	mà
ots	ót	ót
kremer	krểm	krểm
samar	sẩm	sẩm
ayr	ảy	ảy
saris	sái	sái
taux	tãu	tãu
tanf	tàn	tàn
yj	ỵ	ỵ
acf	àc	àc
aur	ảu	ảu
mesmer	mểm	mểm
mops	móp	móp
tars	tá	tá
byes	byé	byé
quos	quó	quó
basf	bà	bà
nys	ný	ný
dyers	dyé	dyé
mejor	mẻo	mẻo
dufour	duỏu	duỏu
ruf	rù	rù
engr	ẻng	ẻng
onr	ỏn	ỏn
coir	cỏi	cỏi
nayar	nẩy	nẩy
daf	dà	dà
oris	ói	ói
ifr	ỉ	ỉ
quasar	quẩ	quẩ
diener	diển	diển
soaks	soák	soák
nef	nè	nè
afs	á	á
chums	chúm	chúm
rois	rói	rói
sways	sưáy	sưáy
biens	bién	bién
noirs	nói	nói
coser	coẻ	coẻ
chasms	chams	chams
lef	lè	lè
lus	lú	lú
tarr	tar	tar
rufous	ruóu	ruóu
doj	dọ	dọ
ojos	ố	ố
escher	ểch	ểch
caf	cà	cà
apj	ạp	ạp
fetes	ffetes	fetes
corsairs	coái	coái
astr	ảt	ảt
roxas	roá	roá
veces	vếc	vếc
iaf	ìa	ìa
hefner	hển	hển
arif	ài	ài
hoists	hoits	hoits
noms	nóm	nóm
kronor	krổn	krổn
hopf	hòp	hòp
naxos	náo	náo
thins	thín	thín
dudes	đué	đué
thes	thé	thé
hox	hõ	hõ
taf	tà	tà
lief	liè	liè
haps	háp	háp
loams	loám	loám
guar	gủa	gủa
vocs	vóc	vóc
gins	gín	gín
nus	nú	nú
penser	pển	pển
lox	lõ	lõ
cursors	cuó	cuó
muons	muón	muón
bons	bón	bón
hangars	hấng	hấng
rais	rái	rái
musics	muics	muics
dax	dã	dã
amf	àm	àm
hepes	hếp	hếp
comr	cỏm	cỏm
sujets	suét	suét
emr	ẻm	ẻm
khans	khán	khán
roasts	roats	roats
damas	dấm	dấm
erf	è	è
bix	bĩ	bĩ
thats	thát	thát
treks	trék	trék
cocos	cốc	cốc
mif	mì	mì
poser	poẻ	poẻ
ists	its	its
rar	rả	rả
inj	ịn	ịn
phos	phó	phó
moats	moát	moát
cursus	cúu	cúu
carats	cất	cất
mers	mé	mé
syr	sỷ	sỷ
ressources	resources	resources
anf	àn	àn
asuras	ấu	ấu
lajos	láo	láo
quips	quíp	quíp
deduces	đếuc	đếuc
wks	ứk	ứk
tox	tõ	tõ
hums	húm	húm
dux	dũ	dũ
moir	mỏi	mỏi
wschr	ửch	ửch
casus	cáu	cáu
acrs	ác	ác
esf	è	è
quas	quá	quá
iar	ỉa	ỉa
erster	ểt	ểt
mors	mó	mó
exner	ển	ển
suf	sù	sù
perspex	pễp	pễp
swf	sừ	sừ
nif	nì	nì
pemex	pễm	pễm
neces	nếc	nếc
gor	gỏ	gỏ
buts	bút	bút
vars	vá	vá
kir	kỉ	kỉ
kis	kí	kí
pwr	pử	pử
asaf	ầ	ầ
lems	lém	lém
carus	cáu	cáu
achr	ảch	ảch
oes	oé	oé
auras	ấu	ấu
dus	dú	dú
trots	trót	trót
tots	tót	tót
ursus	úu	úu
kronos	krốn	krốn
mics	míc	míc
cws	cứ	cứ
bestsellers	betsellers	betsellers
thir	thỉ	thỉ
darf	dà	dà
ois	ói	ói
maus	máu	máu
cachar	cẩch	cẩch
pws	pứ	pứ
roams	roám	roám
rusts	ruts	ruts
heros	héo	héo
mims	mím	mím
meps	mép	mép
sats	sát	sát
emer	ểm	ểm
tias	tía	tía
lof	lò	lò
hij	hị	hị
ues	ué	ué
tims	tím	tím
aif	ài	ài
dienes	diến	diến
lotos	lốt	lốt
goer	goẻ	goẻ
ustr	ủt	ủt
casos	cáo	cáo
myr	mỷ	mỷ
tej	tẹ	tẹ
esops	eops	eops
asis	ái	ái
gaur	gảu	gảu
ansar	ẩn	ẩn
misr	mỉ	mỉ
vwf	vừ	vừ
chars	chá	chá
rix	rĩ	rĩ
mums	múm	múm
uts	út	út
hirer	hier	hier
sops	sóp	sóp
amax	ẫm	ẫm
gyms	gým	gým
ruses	rues	rues
gaf	gà	gà
rescher	rểch	rểch
suas	súa	súa
khas	khá	khá
nips	níp	níp
curfews	cứe	cứe
horas	hoá	hoá
guyer	guyẻ	guyẻ
sws	sứ	sứ
sif	sì	sì
bors	bó	bó
bair	bải	bải
truisms	truims	truims
pharos	pháo	pháo
nays	náy	náy
sers	sé	sé
morons	mốn	mốn
wms	ứm	ứm
duds	đú	đú
oms	óm	óm
tif	tì	tì
uas	úa	úa
ders	dé	dé
nueces	nuếc	nuếc
hys	hý	hý
bajaj	baj	baj
vix	vĩ	vĩ
ests	ets	ets
lier	liẻ	liẻ
vips	víp	víp
truax	trũa	trũa
mier	miẻ	miẻ
majus	máu	máu
wx	ữ	ữ
dois	dói	dói
mux	mũ	mũ
cof	cò	cò
dorf	dò	dò
nof	nò	nò
qasr	qả	qả
bursar	bủa	bủa
apf	àp	àp
varnas	vấn	vấn
nuys	nuý	nuý
coef	coè	coè
aspx	ãp	ãp
curs	cú	cú
recs	réc	réc
ief	iè	iè
churns	chún	chún
vermes	vếm	vếm
mamas	mấm	mấm
tems	tém	tém
mox	mõ	mõ
vois	vói	vói
uris	úi	úi
imr	ỉm	ỉm
lais	lái	lái
metes	mết	mết
amj	ạm	ạm
usps	ups	ups
chur	chủ	chủ
bots	bót	bót
larus	láu	láu
posix	põi	põi
nias	nía	nía
meses	mes	mes
puer	puẻ	puẻ
eor	ẻo	ẻo
duos	duó	duó
tux	tũ	tũ
nats	nát	nát
oaf	oà	oà
langs	láng	láng
kreps	krép	krép
nux	nũ	nũ
corms	cóm	cóm
loris	lói	lói
rans	rán	rán
dims	dím	dím
sachar	sẩch	sẩch
lochs	lóch	lóch
thur	thủ	thủ
lir	lỉ	lỉ
trias	tría	tría
daraus	dấu	dấu
usus	úu	úu
etf	èt	èt
sauf	sàu	sàu
swets	sưét	sưét
efs	é	é
kes	ké	ké
saur	sảu	sảu
boj	bọ	bọ
gir	gỉ	gỉ
haf	hà	hà
thaf	thà	thà
etr	ẻt	ẻt
khor	khỏ	khỏ
cays	cáy	cáy
theos	théo	théo
iprs	íp	íp
eres	ế	ế
papas	pấp	pấp
chos	chó	chó
techs	téch	téch
dej	dẹ	dẹ
kins	kín	kín
gorer	goer	goer
vias	vía	vía
quires	quié	quié
quar	quả	quả
kerns	kén	kén
acas	ấc	ấc
morais	moái	moái
worf	ườ	ườ
nits	nít	nít
tras	trá	trá
soas	soá	soá
euer	ểu	ểu
chor	chỏ	chỏ
burs	bú	bú
ifrs	í	í
itf	ìt	ìt
gaor	gảo	gảo
ofs	ó	ó
wcs	ức	ức
berns	bén	bén
vif	vì	vì
gams	gám	gám
camas	cấm	cấm
duas	dúa	dúa
qur	qủ	qủ
uscs	ucs	ucs
demes	dếm	dếm
miers	mié	mié
esos	éo	éo
saif	sài	sài
siraj	sịa	sịa
nws	nứ	nứ
menezes	mến	mến
dacs	dác	dác
caus	cáu	cáu
sef	sè	sè
ches	ché	ché
charis	chái	chái
vais	vái	vái
irf	ì	ì
coj	cọ	cọ
gits	gít	gít
gies	gié	gié
causas	cấu	cấu
duer	duẻ	duẻ
usis	úi	úi
osf	ò	ò
ofr	ỏ	ỏ
taxus	táu	táu
lianas	líân	líân
transf	tràn	tràn
yx	ỹ	ỹ
musts	muts	muts
nars	ná	ná
conj	cọn	cọn
sofer	soẻ	soẻ
suraj	sụa	sụa
ganj	gạn	gạn
chamar	chẩm	chẩm
lairs	lái	lái
lwr	lử	lử
rias	ría	ría
tums	túm	túm
coif	còi	còi
seps	sép	sép
parus	páu	páu
homs	hóm	hóm
anj	ạn	ạn
armrests	amrests	amrests
doms	dóm	dóm
ajnr	ản	ản
wus	ứu	ứu
harar	har	har
larix	lãi	lãi
etfs	ét	ét
kyr	kỷ	kỷ
canr	cản	cản
thier	thiẻ	thiẻ
benj	bẹn	bẹn
aras	ấ	ấ
marsyas	mấy	mấy
sems	sém	sém
cofer	coẻ	coẻ
paros	páo	páo
huis	húi	húi
thys	thý	thý
tuns	tún	tún
bienes	biến	biến
mef	mè	mè
laf	là	là
guis	gúi	gúi
sechs	séch	séch
pois	pói	pói
wps	ứp	ứp
oems	oém	oém
otr	ỏt	ỏt
phasors	pháo	pháo
aor	ảo	ảo
parnas	pấn	pấn
nier	niẻ	niẻ
naif	nài	nài
atas	ất	ất
minx	mĩn	mĩn
oer	oẻ	oẻ
enfer	ển	ển
dox	dõ	dõ
nachr	nảch	nảch
kier	kiẻ	kiẻ
kamaraj	kkamaraj	kamaraj
unf	ùn	ùn
demers	dếm	dếm
maur	mảu	mảu
aircrafts	aicrafts	aicrafts
rauf	ràu	ràu
mys	mý	mý
coms	cóm	cóm
wos	ướ	ướ
somos	sốm	sốm
asps	aps	aps
vins	vín	vín
rur	rủ	rủ
lins	lín	lín
rej	rẹ	rẹ
vues	vué	vué
ipf	ìp	ìp
lecher	lểch	lểch
hots	hót	hót
thej	thẹ	thẹ
teos	téo	téo
locos	lốc	lốc
ays	áy	áy
otf	òt	òt
isf	ì	ì
bwr	bử	bử
laus	láu	láu
botox	bỗt	bỗt
basor	bảo	bảo
thasos	tháo	tháo
borns	bón	bón
usfs	ú	ú
execs	ếc	ếc
panas	pấn	pấn
leos	léo	léo
mij	mị	mị
tef	tè	tè
tirer	tier	tier
phips	phíp	phíp
chamars	chấm	chấm
heuser	hểu	hểu
denr	dẻn	dẻn
hif	hì	hì
bex	bẽ	bẽ
heuer	hểu	hểu
gyr	gỷ	gỷ
usf	ù	ù
thair	thải	thải
rues	rué	rué
viens	vién	vién
gwr	gử	gử
hamar	hẩm	hẩm
anr	ản	ản
utf	ùt	ùt
xanax	xẫn	xẫn
seems	sếm	sếm
poor	pổ	pổ
door	dổ	dổ
laws	lắ	lắ
trees	trế	trế
troops	trốp	trốp
rooms	rốm	rốm
towns	tớn	tớn
roots	rốt	rốt
sees	sế	sế
doors	dố	dố
roof	rồ	rồ
beer	bể	bể
keeps	kếp	kếp
rows	rớ	rớ
peer	pể	pể
meets	mết	mết
deer	dể	dể
peers	pế	pế
deeds	đế	đế
beef	bề	bề
boots	bốt	bốt
cows	cớ	cớ
chooses	chốe	chốe
poorer	pổe	pổe
loops	lốp	lốp
owns	ớn	ớn
bees	bế	bế
reef	rề	rề
queer	quể	quể
teens	tến	tến
roofs	rố	rố
cheer	chể	chể
queens	quến	quến
downs	dớn	dớn
bows	bớ	bớ
vows	vớ	vớ
reefs	rế	rế
moor	mổ	mổ
gaas	gấ	gấ
cheers	chế	chế
looms	lốm	lốm
moors	mố	mố
hawks	hắk	hắk
lawns	lắn	lắn
beers	bế	bế
rees	rế	rế
veneer	vener	vener
voor	vổ	vổ
haas	hấ	hấ
seer	sể	sể
gowns	gớn	gớn
deems	dếm	dếm
moons	mốn	mốn
doorways	dơáy	dơáy
hoof	hồ	hồ
beets	bết	bết
lees	lế	lế
saws	sắ	sắ
seers	sế	sế
booms	bốm	bốm
lows	lớ	lớ
hoops	hốp	hốp
hoofs	hố	hố
looser	lổe	lổe
aas	ấ	ấ
meer	mể	mể
sows	sớ	sớ
referees	rểees	rểees
veer	vể	vể
saar	sar	sẩ
dodds	đó	đó
pawns	pắn	pắn
roos	rố	rố
loos	lố	lố
mawr	mẳ	mẳ
maas	mấ	mấ
tees	tế	tế
leer	lể	lể
dawns	dắn	dắn
cocoons	cocons	cocons
moos	mố	mố
seeps	sếp	sếp
woof	uồ	uồ
heer	hể	hể
haar	hẩ	hẩ
oops	ốp	ốp
naar	nẩ	nẩ
aaf	ầ	ầ
dds	đs	đs
ees	ế	ế
monsoons	mónons	mónons
veneers	veners	veners
noor	nổ	nổ
aar	ẩ	ẩ
deeps	dếp	dếp
coons	cốn	cốn
moores	mốe	mốe
boor	bổ	bổ
aaas	aas	aas
coors	cố	cố
kees	kế	kế
coos	cố	cố
baas	bấ	bấ
dees	dế	dế
aws	ắ	ắ
boos	bố	bố
maar	mẩ	mẩ
queers	quế	quế
veers	vế	vế
oozes	oé	oé
toots	tốt	tốt
goons	gốn	gốn
hoots	hốt	hốt
pensees	pénes	pénes
loons	lốn	lốn
hows	hớ	hớ
coops	cốp	cốp
neer	nể	nể
chooser	chổe	chổe
tows	tớ	tớ
goof	gồ	gồ
paar	pẩ	pẩ
beeps	bếp	bếp
boons	bốn	bốn
dooms	dốm	dốm
peeps	pếp	pếp
oor	ổ	ổ
eer	ể	ể
awacs	ấc	ấc
teems	tếm	tếm
raaf	rầ	rầ
swoops	suốp	suốp
cowpox	cỗp	cỗp
eets	ết	ết
poof	pồ	pồ
thaws	thắ	thắ
mees	mế	mế
looses	lốe	lốe
macaws	mắc	mắc
wallflower	ửàlllowe	ửàlllowe
nees	nế	nế
usaaf	uầ	uầ
powis	pới	pới
aways	ấy	ấy
coots	cốt	cốt
daws	dắ	dắ
choosers	chốe	chốe
