# English 100k Failures - Vowel Patterns
# Cause: aa/ee/oo/aw/ow/uw/dd trigger vowel transforms
# Format: WORD \t ACTUAL \t BUFFER
# Total: 264 (+ 148 both)
#
# WORD: English word typed
# ACTUAL: engine output after space
# BUFFER: Vietnamese transform state before space

been	bên	bên
see	sê	sê
how	hơ	hơ
now	nơ	nơ
own	ơn	ơn
down	dơn	dơn
too	tô	tô
seen	sên	sên
low	lơ	lơ
room	rôm	rôm
soon	sôn	sôn
town	tơn	tơn
seem	sêm	sêm
meet	mêt	mêt
tree	trê	trê
choose	chốe	chốe
queen	quên	quên
root	rôt	rôt
row	rơ	rơ
lee	lê	lê
moon	môn	môn
loose	lốe	lốe
loop	lôp	lôp
thee	thê	thê
moore	mổe	mổe
dawn	dăn	dăn
bow	bơ	bơ
cow	cơ	cơ
deed	đê	đê
keen	kên	kên
noon	nôn	nôn
boom	bôm	bôm
aa	â	â
doorway	dơảy	dơảy
lawn	lăn	lăn
bee	bê	bê
boot	bôt	bôt
gown	gơn	gơn
hawk	hăk	hăk
troop	trôp	trôp
boost	bốt	bốt
oo	ô	ô
teen	tên	tên
eec	êc	êc
goose	gốe	gốe
poorest	pôét	pôét
doom	dôm	dôm
ee	ê	ê
dow	dơ	dơ
vow	vơ	vơ
sown	sơn	sơn
dee	dê	dê
sow	sơ	sơ
loom	lôm	lôm
ooo	oo	oo
tow	tơ	tơ
dd	đ	đ
tee	tê	tê
deem	dêm	dêm
monsoon	mónon	mónon
boon	bôn	bôn
moose	mốe	mốe
een	ên	ên
dodd	dod	dod
nee	nê	nê
aaa	aa	aa
loosen	lôén	lôén
beech	bêch	bêch
beet	bêt	bêt
ddt	đt	đt
canaan	canan	canan
musee	múee	muế
referee	rểee	rểee
woo	uô	uô
chow	chơ	chơ
hoop	hôp	hôp
soot	sôt	sôt
rowan	rơan	rơan
cowan	cơan	cơan
hee	hê	hê
pow	pơ	pơ
loo	lô	lô
loot	lôt	lôt
boo	bô	bô
moot	môt	môt
pawn	păn	păn
ow	ơ	ơ
renee	rene	rene
norwood	noỏd	noỏd
leech	lêch	lêch
pee	pê	pê
coop	côp	côp
cocoon	cocon	cocon
booze	boe	boe
ree	rê	rê
coo	cô	cô
coon	côn	côn
roost	rốt	rốt
puree	pủee	puể
noose	nốe	nốe
mee	mê	mê
beseech	beéch	beéch
uaw	ưa	ưa
mow	mơ	mơ
gaap	gâp	gâp
soo	sô	sô
aan	ân	ân
heen	hên	hên
loon	lôn	lôn
hoo	hô	hô
kee	kê	kê
rostow	rớt	rớt
noaa	noâ	noâ
doo	dô	dô
moo	mô	mô
ghee	ghê	ghê
caa	câ	câ
iaa	iâ	iâ
ooze	oe	oe
sawn	săn	săn
chee	chê	chê
yee	yê	yê
naa	nâ	nâ
uw	ư	ư
vee	vê	vê
hoot	hôt	hôt
poop	pôp	pôp
goo	gô	gô
baa	bâ	bâ
saa	sâ	sâ
dowd	đơ	đơ
roo	rô	rô
poore	pổe	pổe
dde	đe	đe
gooch	gôch	gôch
maa	mâ	mâ
paa	pâ	pâ
meerut	mểut	mểut
nowak	nơak	nơak
enfeebled	ènebled	ènebled
poo	pô	pô
pensee	péne	péne
aac	âc	âc
choo	chô	chô
iee	iê	iê
ddc	đc	đc
neem	nêm	nêm
haan	hân	hân
soong	sông	sông
aarp	ẩp	ẩp
toot	tôt	tôt
oop	ôp	ôp
saarc	sẩc	sẩc
oeec	oêc	oêc
oooo	ooo	ooo
gow	gơ	gơ
eez	e	e
dda	đa	đa
tepee	tepe	tepe
taa	tâ	tâ
aap	âp	âp
chaffee	chafee	chafee
doon	dôn	dôn
eeo	êo	êo
ddd	dd	dd
haa	hâ	hâ
ddl	đl	đl
mown	mơn	mơn
uwe	ưe	ưe
veen	vên	vên
dowson	dốn	dốn
eee	ee	ee
deen	dên	dên
nawaz	na	na
ooooo	oooo	oooo
noo	nô	nô
goon	gôn	gôn
aat	ât	ât
peet	pêt	pêt
horwood	hoỏd	hoỏd
trow	trơ	trơ
mowat	mơat	mơat
powwow	powow	powow
coot	côt	côt
boxwood	boõd	boõd
hopwood	hopod	hopod
tdd	tđ	tđ
gaa	gâ	gâ
seest	sết	sết
thurow	thuở	thuở
awt	ăt	ăt
oot	ôt	ôt
refereed	rểeed	rểeed
toon	tôn	tôn
hooray	hôảy	hôảy
gowan	gơan	gơan
longwood	longod	longod
poon	pôn	pôn
ddp	đp	đp
aau	âu	âu
aam	âm	âm
oort	ổt	ổt
meech	mêch	mêch
owi	ơi	ơi
eet	êt	êt
leet	lêt	lêt
vdd	vđ	vđ
lowi	lơi	lơi
nonfood	nònod	nònod
meow	meơ	meơ
macaw	măc	măc
oom	ôm	ôm
aai	âi	âi
teem	têm	têm
daa	dâ	dâ
pdd	pđ	pđ
awk	ăk	ăk
veneered	venered	venered
heeft	hềt	hềt
hooch	hôch	hôch
aaaa	aaa	aaa
bdd	bđ	bđ
maat	mât	mât
laa	lâ	lâ
oon	ôn	ôn
lowa	lơa	lơa
oost	ốt	ốt
deedee	đêee	đêee
mdd	mđ	mđ
hiaa	hiâ	hiâ
duree	dủee	duể
towson	tốn	tốn
hoon	hôn	hôn
ddi	đi	đi
booz	bo	bo
raa	râ	râ
awn	ăn	ăn
hooft	hồt	hồt
oaa	oâ	oâ
haart	hẩt	hẩt
beseeched	beéched	beéched
tyree	tỷee	tyể
owa	ơa	ơa
eero	ểo	ểo
gawk	găk	găk
cooch	côch	côch
oroonoko	oỏnoko	oỏnoko
awwa	awa	awa
oooh	ooh	ooh
pauw	paư	paư
chowk	chơk	chơk
khoo	khô	khô
howson	hốn	hốn
bowra	bởa	bởa
oooooooo	ooooooo	ooooooo
daan	dân	dân
fdd	fđ	fđ
roon	rôn	rôn
lown	lơn	lơn
roop	rôp	rôp
oooooo	ooooo	ooooo
huw	hư	hư
pooch	pôch	pôch
coosa	cốa	cốa
seems	sếm	sếm
poor	pổ	pổ
door	dổ	dổ
laws	lắ	lắ
trees	trế	trế
troops	trốp	trốp
rooms	rốm	rốm
towns	tớn	tớn
roots	rốt	rốt
sees	sế	sế
doors	dố	dố
roof	rồ	rồ
beer	bể	bể
keeps	kếp	kếp
rows	rớ	rớ
peer	pể	pể
meets	mết	mết
deer	dể	dể
peers	pế	pế
deeds	đế	đế
beef	bề	bề
boots	bốt	bốt
cows	cớ	cớ
chooses	chốe	chốe
poorer	pổe	pổe
loops	lốp	lốp
owns	ớn	ớn
bees	bế	bế
reef	rề	rề
queer	quể	quể
teens	tến	tến
roofs	rố	rố
cheer	chể	chể
queens	quến	quến
downs	dớn	dớn
bows	bớ	bớ
vows	vớ	vớ
reefs	rế	rế
moor	mổ	mổ
gaas	gấ	gấ
cheers	chế	chế
looms	lốm	lốm
moors	mố	mố
hawks	hắk	hắk
lawns	lắn	lắn
beers	bế	bế
rees	rế	rế
veneer	vener	vener
voor	vổ	vổ
haas	hấ	hấ
seer	sể	sể
gowns	gớn	gớn
deems	dếm	dếm
moons	mốn	mốn
doorways	dơáy	dơáy
hoof	hồ	hồ
beets	bết	bết
lees	lế	lế
saws	sắ	sắ
seers	sế	sế
booms	bốm	bốm
lows	lớ	lớ
hoops	hốp	hốp
hoofs	hố	hố
looser	lổe	lổe
aas	ấ	ấ
meer	mể	mể
sows	sớ	sớ
referees	rểees	rểees
veer	vể	vể
saar	sar	sẩ
dodds	đó	đó
pawns	pắn	pắn
roos	rố	rố
loos	lố	lố
mawr	mẳ	mẳ
maas	mấ	mấ
tees	tế	tế
leer	lể	lể
dawns	dắn	dắn
cocoons	cocons	cocons
moos	mố	mố
seeps	sếp	sếp
woof	uồ	uồ
heer	hể	hể
haar	hẩ	hẩ
oops	ốp	ốp
naar	nẩ	nẩ
aaf	ầ	ầ
dds	đs	đs
ees	ế	ế
monsoons	mónons	mónons
veneers	veners	veners
noor	nổ	nổ
aar	ẩ	ẩ
deeps	dếp	dếp
coons	cốn	cốn
moores	mốe	mốe
boor	bổ	bổ
aaas	aas	aas
coors	cố	cố
kees	kế	kế
coos	cố	cố
baas	bấ	bấ
dees	dế	dế
aws	ắ	ắ
boos	bố	bố
maar	mẩ	mẩ
queers	quế	quế
veers	vế	vế
oozes	oé	oé
toots	tốt	tốt
goons	gốn	gốn
hoots	hốt	hốt
pensees	pénes	pénes
loons	lốn	lốn
hows	hớ	hớ
coops	cốp	cốp
neer	nể	nể
chooser	chổe	chổe
tows	tớ	tớ
goof	gồ	gồ
paar	pẩ	pẩ
beeps	bếp	bếp
boons	bốn	bốn
dooms	dốm	dốm
peeps	pếp	pếp
oor	ổ	ổ
eer	ể	ể
awacs	ấc	ấc
teems	tếm	tếm
raaf	rầ	rầ
swoops	suốp	suốp
cowpox	cỗp	cỗp
eets	ết	ết
poof	pồ	pồ
thaws	thắ	thắ
mees	mế	mế
looses	lốe	lốe
macaws	mắc	mắc
wallflower	ửàlllowe	ửàlllowe
nees	nế	nế
usaaf	uầ	uầ
powis	pới	pới
aways	ấy	ấy
coots	cốt	cốt
daws	dắ	dắ
choosers	chốe	chốe
